11111111111111111111111111111111111111111111111111111111111111111111111111111111111111111111111111111111111111111111111111111111111111111111
1XXXXXXXXXXXXXXXXXXXXXXXXXXXXXXXXXXXXXXXXXXXXXXXXXXXXXXXXXXXXXXXXXXXXXXXXXXXXXXXXXXXXXXXXXXXXXXXXXXXXXXXXXXXXXXXXXXXXXXXXXXXXXXXXXXXXXXXXXX1
1XXXXXXXXXXXXXXXXXXXXXXXXXXXXXXXXXXXXXXXXXXXXXXXXXXXXXXXXXXXXXXXXXXXXXXXXXXXXXXXXXXXXXXXXXXXXXXXXXXXXXXXXXXXXXXXXXXXXXXXXXXXXXXXXXXXXXXXXXX1
1XXXXXXXXXXXXXXXXXXXXXXXXXXXXXXXXXXXXXXXXXXXXXXXXXXXXXXXXXXXXXXXXXXXXXXXXXXXXXXXXXXXXXXXXXXXXXXXXXXXXXXXXXXXXXXXXXXXXXXXXXXXXXXXXXXXXXXXXXX1
1XXXXXXXXXXXXXXXXXXXXXXXXXXXXXXXXXXXXXXXXXXXXXXXXXXXXXXXXXXXXXXXXXX00XXX00011111111111100000000111111111111111111111111111111111111111111111
1XXXXXXXXXXXXXXXXXXXXXXXXXXXXXXXXXXXXXXXXXXXXXXXXXXXXXXXXXXXXXXXXX00000100001111111111100000000001111111111111111111111111111111111111111111
1XXXXXXXXXXXXXXXXXXXXXXXXXXXXXXXXXXXXXXXXXXXXXXXXXXXXXXXXXXXXXX0000000001000XXXXXXXXXXXX0000000000XXXXXXXXXXXXXXXXXXXXXXXXXXXXXXXXXXXXXXXXX1
1XXXXXXXXXXXXXXXXXXXXXXXXXXXXXXXXXXXXXXXXXX00XXXXXX000111111111000X0000000001111111111110000000000111111111001111111111111111111111111111111
1XXXXXXXXXXXXXXXXXXXXXXXXXXXXXXXX00XX0000XX00011111000XXX00XXXXX000000000000XXXXXXXX00000000X0000XXXXXXXXXX00XXXXXXXXXXXXXXXXXXXXXXXXXXXXXX1
1XXXXXXXXXXXXXXXXXXXXXXXXXXXXXXX00000000011000XXXX0000000000000000000000X0000X00XX0000000000000000XXXXXXXX0000X00XXXXXXXXXXXXXXXXXXXXXXXXXX1
1XXXXXXXXXXXXXXXXXXXXXXXXXXXXXXX000000000000000100000000000000000000000000000000000000000000000000000XXXXX0000000111001111111111111111111111
1XXXXXXXXXXXXXXXXXXXXXXXXXXXXXX0000000000000000X00XX00000000X0000000000000000000000000000000000000000X00X000000000100000XXXXXXXXXXXXXXXXXXX1
1XXXXXXXXXXXXXXXXXXXXXXXXXXXXXX0000000000000000000000000000000000000000000000000001100000000000000000000000000000000000011111111111111111111
1XXXXXXXXXXXXXXXXXXXXXXXXXXXXXX0000000000000000000000000000000000000000000000000100000000000000000010000000000000X00000001111111111111111111
1XXXXXXXXXXXXXXXXXXXXXXXXXXXXXX0000000000000000000000000000000000000000000000000000000000000000000000000000000000000000000000XX0001111111111
1XXXXXXXXXXXXXXXXXXXXXXXXXXX00000000X000000000000000000X000000000000000000000000000000000000000000000000000001000000000000000X0000XXXXXXXXX1
1XXXXXXXXXXXXXXXXXXXXXXXXXXX00000000000000X000000000000000000000000000000000000000000000000000000X000000000000000000000000000100001111111111
1XXXXXXXXXXXXXXXXXXXXXXXXXX00X00000000000000000000000000000001000000000000000XX00000000000000000000000000X0000000000010000000000001111111111
1XXXXXXXXXXXXXXXXXXXXXX00010000000X000000X00010000000000000000000000000000000010000000000000X0000000000000000X00000000000000000000XXXXXXXXX1
1XXXXXXXXXXXXXXXXXXXXXX00010000000000000000000000000X00000100000000000000000000000000000000000000000000000000000010000001000000000XXXXXXXXX1
1XXXXXXXXXXXXXXXXXXXXX00011100000000000000000010000000000001001000000000000000000001000000000000000000000000000000000000000000000XXXXXXXXXX1
1XXXXXXXXXXXXXXXXXXX00000000000000X000000000000000000000000000000000000000000000000010000000X00000000000000000000000000000000X00XX00XXXXXXX1
1XXXXXXXXXXXXXXXXXXX0000X0000000000000000000000000000000100000000000000000X000000000000000000000000000000000000000000000000000000X00XXXXXXX1
1XXXXXXXXXXXXXXXXXXXX00000000X000000000000000000000000000001000010000000000000000000000000000000010000000000000000000000000000000X00XXXXXXX1
1XXXXXXXXXXXXXXXXXXXX0000000000000000000000000000000000X00000000000000000000010000000000000000000000000X0000000000000000000000000000XXXXXXX1
1XXXXXXXXXXXXXXX00XXX000000000000000000000100000X0000000000000000000000000000000000000000000000000000000000000000000000000000000000011111111
1XXXXXXXXXXXXX0000000000000000000000000000000000000000X000000000000000000X0000000000000000000000000000000000000000000000000000000000XXXXXXX1
1XXXXXXXXXX0000000000000000000000000000X000000000000000000000000000000000000000000000001000000000000000000000000000000000000000X00XXXXXXXXX1
1XXXXXXX00X00000000000000000000000000000000000000000000000000X0000000001000000000000000000000X0000000000000000000000000000000000000001111111
1XXXXXXX0001000000000000000000000000000000000X0000000001000000000000000000000000000000000000000000000000000000000000000000001000000001111111
1XXXXXXX000000000000000000000000X000000000000000000000000000000000000000000000000010000000X000000000000000000000000X00000000000000XXXXXXXXX1
1XXXXXXX000000000000000000000000000000000000000000000000000000000000000000000000000000X00000000X00000000000000000000000000000000011111111111
1XXXXXXX00000000000000000000000000000000000000000000000000000000X0000000000000000000000000000X0000000000000000000000000000000000011111111111
1XXXXXX0000000000000000000000000000000000000000000000000000000000000000000000000000000000000000000000000000000000X0000000000000000XXXXXXXXX1
1XXXX0000000000000000000000000000000000000000X000000X00X000000000000000000000000X0000000000000000000000000100000000000000000000000XXXXXXXXX1
1XXXX000000000000000000000000000000000000000000000000000000000000000000000000000000000000000000000000000000000100000X00X00X00000000011111111
1XXXX0000000000000000000000000000000000000000000000000000000000000000000000000000000000010000001000000000000000000000X00000000000000XXXXXXX1
1XXXX000000000000000000000000000000000000000000000000000000000000000000000000000000000000000000000000000000010000000000000000000000111111111
1XXXX00000000000000X00000001000000000000000000000000000X00X00000000000000000000000000000000X00X000100000000000000000000000000000000111111111
1XXX00000000000000000000000000000000000000000000000000000000000000000000000000000000000000000000000000000000000000000001000000000XXXXXXXXXX1
1XXX00000000000000000000000000000000000000000001000000000000000X0000000000000000000000X00X0000000000000000X000000000000000000000111111111111
1XXXXX00XXXX000000000000000000000000000000000000000000000000000000000000010000000000000000000X0000X00X00X00000000000000000000000111111111111
1XXXX000100000000100001000000000000000000000000000000000000001000000000000000000000000000000000000000000000000000000000000000000001111111111
1XXXX00010000000000000000000000000000000X000000X000000000100000000000000000000000000000000100000000000000000000000000000000000000000XXXXXXX1
1XXXX00XXX0000000000X00000000000000000000000100000000000000000000000000000000000000000X000000000000000100000000000000000000000000000XXXXXXX1
1XXXXXXXX0000000000000000000000000000000000000000000000000000000000000000000100000000001000000000000000000001000000000000001000000000XXXXXX1
1XXXXXXXX00000000000000000000000000000000000000X0000X000000000000000000000000000000000000000000000100000000000000000000000000000000001111111
1XXXXXXXXX00X00X00X00X000000000000000100000000000000000000000000000X0000000000000000X00000000000000000000000000XX000000000000000000011111111
1XXXXXXXXX00000000000000000000X000000000000000000000000X0000X000000000000000100100000000000000000000000000000000000000000000000000000XXXXXX1
1XXXXXXXXX0000000000000000X0000000000000000000000000000000000000000000000000000000000000000000000000000000000000000000000000000000000XXXXXX1
1XXXXXXXXXX0000000000000000000000000000000000000000000000000000000000X0000000000000000000000000001000000000000000000000000000000000011111111
1XXXXXXXXXXX00000000000000000000000000X0000X000000000000000000X00000000000000000000000000000001000000000000000000000000000000000XXXXXXXXXXX1
1XXXXXXXX000000000000X0000000000000000000000000000000000000000000000X00000000000000000000000000000000000000000000000000000000000001111111111
1XXXX00XX00000000000100000000000000000000000000000000000000000000000000000000000000000000000000000000000000000000000000100000000000XXXXXXXX1
1XXX0000000000000000000000000000000000000000000000000000X00000001001000000000000000000000000000000000000000000100000000000000100000XXXXXXXX1
1XXX0000000000000000000000000000000000000000000000000000000000000000000000000000000000000000000000000000000000000000000000010000001111111111
1XXXX000000000000000100000000000000000000000000000000000010000000000000000100000000000000000000000000000000000000000000100000000000XXXXXXXX1
1XXXX0000000000000000X0000000000000000000000000000000000X00000000000000000000000000000000000000000000000000000000000000000000000000XXXXXXXX1
1XXXXX00000000010000000000000000000000000000000X00000000000000000000000000000000000000000000000000000000000000000000000000000000000111111111
1XXXXXX00X0000000000000000000000000000000000000000000000000001000000000000000000000000000000000000000000000000000000000X00000000000111111111
1XXX00000000X0000000000X00000000000000000000000000000000000000010000000000000X000100000X000000000000X0000000000000000000000000000XXXXXXXXXX1
1XXX000000000000000000000000000000000000000000000000000000000000000000000000XX000000000000000000000000000000000000X0000000000000111111111111
1X000000000100000000000000000000000000000000000000000000000000000000000000000000000000000000000000000X0000000000000000000000000000XXXXXXXXX1
1X000000000000000000000000000000X0000000000000000000000000000X000000000000000000010000000000000000000000000000000000000000000000001111111111
1X0000000000000000000000000000000000000000000000000000000000000000XX0000000000000000X0000000000000000000000000000000000000000010011111111111
1X00000000010000000000000000000000000000000000000000000000000010011110000000000000000000000000000000000000000100000000000010000000XXXXXXXXX1
1XXX0000XX0000000000000000000000X0000000000000000000000000000XXXXXXXX0001100000000000000000000000000000010000000000000000000000000XXXXXXXXX1
1XXX0000XX000000000000000000X00000000000000000000000000X000111111111100111110000000000000000000010000000000000000000000000000100001001111111
1XXX00XXX000000000000000000X0000000000X00000000000000000100111111111111111100000000000000000000000000000000001000000000000000000001001111111
1XXXXXX000000000000000000000000000000000000000000000000000001111111111111100000000000000000000000X00000000000000000000000000000000X00XXXXXX1
1XXXX000000000000000000000000000000000000000001000010000000011111111111111000000000000000000000000000000000000000010000000000001001000011111
1X000000000000000000000000000000000000X000000000001000000000000001111111111100000000000000000000000000000000000000000000000000000000000XXXX1
1X00000000010000000000100000000000000000X000000000000000000000000XXXXXXXXXXX0001000000000X0000000000010000000000000000000X00X00000000XXXXXX1
1XX00000000000000000000000000000000000000000000000000000000000001111111111111111000000000000000000000000000000000000000000000000000000000XX1
1X000000000000000100000000000000000000000000000X00X000000000000011111111111111110000000000000000001000000000000000000000000000000000000000X1
1X000000000000000000000000010000000000000000000000000000000000001111111111111111100001000000000000000000000000000000000000000000000000000011
1XX000000000000000000000000000000000000000000000000000000X00XXXXXXXXXXXXXXXXXXXXX000000000000000000000000000000000000000000000000X0000000111
10000X000000000001000000000000000000000000000000000000000XXXXXXX00XXXXXXX0001111000000000000000000000000000000000000000000000000000000000000
1000000000000000000000000000000000000000000000000000100001111111001111001000XXXX000100100000000000000000000000000000000000X00000000000000000
00000000000000000000000000000000000000000000000000000X0000XXX000001100001000000000000000X00000100000000000000000000000X000000000000000001001
00000000000X0000000000000000000000000000000000000000000000X000000000000000000000000000000X00000000000000000000000000000000000000000000000001
10000000000000000000000000000000000000000000100000000000000000000000000000011000000000000000000000000000000000000000000000000000000000000001
0000000000000000100100000000000000000000000000000000000X000000000000000000000000X000000000000000000X00X000000000000000000010000110000000XXX1
0000001000010010000000000000000000000000000000000000000000XX00000000000000000000000000000100000X0000000000000000000000000000000001000XXXXXX1
10000010011000000000000000000000000000X000000000000000000000000000000000000000100000000000000100000000000000000000000000000000000X0001111111
1XXXXXXXXXX00000000X00X000000X0000000000000000000000000000000000000100000000000000000000000000000000000000000000000000000000000X000000XXXXX1
1XXXXXXXXXXX00000000000000000000000000000000000000000000000000000000000000000001000000100000X00000000000000000000000000000000000000000111111
1XXXXXXXXXXXXX0000000000000000000000000000000000000000000000000000000000000000000000000000000000000000000000000000000000000000000000XXXXXXX1
1XXXXXXXXXXXXX000000000000000000000000000000000000000000X000000000000000000000000000000000000000000000000000000000000000000000000X00XXXXXXX1
1XXXXXXXXXXX000000000000000000000000000000X00000001000000000000000000000000000000000X0000000000000000000100000000000000000010000100111111111
1XXXXXXXXXX0000000000000000000000000000010000000000000000000000000000001000000000000000X0000000000000000000000000000000000000000000111111111
1XXXXXXXXXX000000010010000000000000000000000000000000000000000000000000000000000000000000000000000000000000000100000000000000000000111111111
1XXXXXXXXXX000000000000000000000000000000000001000000000000000000000000000X000000000000000000000000000100000000000000000000000000000XXXXXXX1
1XXXXXXXXXX0000000000000000000000000100000000000000000X00X00000000000000X00000000000000000000X000000X00000000000000000000000000000000XXXXXX1
1XXXXXXXX000000000000000000000000000000000000000000000000000000000000000000000000000000000000000000X00000000X00X0000000000000000000001111111
1XXXXXX000000000000000000000000000000000000000000000000000000000000000000000000000000000000X0000000000000000000000000000000000000000XXXXXXX1
1XXXXXX0000000000X00X00000000000000000000000000000000000000000000000001000000001000X00000000000000000000000000000000000000000000000001111111
1XXXXXX00X0000X0000X0000000000000000000000X0000X00000000000000X00000000000000000000000000000000000000X0000X00X00X000000000000000000000111111
1XXXXXXXXX0000000000000000000000000000000000000000000000000100100000000000000000000000000001000000000000000000000000001000000100000000111111
1XXXXXXXXX000000000000X00000000000000000000000000000000000000000000000000000000000000000000000000000000000000000000000000000000000000XXXXXX1
1XXXXXXXXXXXX0000000000000000000000000000000000000000000000000000000000000000000000000000000000X0000000000X00X00000000000000000000XXXXXXXXX1
1XXXXXXXXXXXX0000000000000100000000000X0000000000X000000X00X000000000000000000000000000001000000000000001000000000000001000000000XXXXXXXXXX1
1XXXXXXXXXXX000000000000000000000000000000000000000000000000000000000000000000000000000000X00000000000000000000000000000000000000XXXXXXXXXX1
1XXXXXXXXXX00000000X000000000000000000000100000000000000000000000000000000000000000000000000000000000000001000000000000000000000011111111111
1XXXXXXXXXX0001000000000000000000000X00X000000000000000000000000000000000000000000X000000000000000000010000000000000000000000000011111111111
1XXXXXXXXXXX00000000X00000001000000000000000000000000000000000000000000000000000000000000000000000000000000001000000000000001001111111111111
1XXXXXXXXXXX0000000000000000000000000000X000000000000000000000000000000000000000000010000100000000100001000000000000000000000000000XXXXXXXX1
1XXXXXXXXXXXXXX0000000000000000000000000000000000000000000000X000000000000000000000000000000000000000000000000000000000000000000000111111111
1XXXXXXXXXXXXX0000000000X000000000000X000000000000000000010000100000X0000000000000000000000000000000000000000000000X000000000000XXXXXXXXXXX1
1XXXXXXXXXXXXX0000000000000000000000X000000000000000100000000000000000000000000000000000000000000000X000000000000000000000000000111111111111
1XXXXXXXXXXXXX000000000000000000000000000000000000000000000000000000000000000000000000000000000000000000000000000000000000000001111111111111
1XXXXXXXXXXXXX000000000001000000000000000000000X0000000000000000X00000000000000000000000100001000000000000000000000000000000000XXXXXXXXXXXX1
1XXXXXXXXXXXXXXXXX000000000000000000X000000000000X0000000000000001000000000000000000000000000000000000000000001000X0000000000011111111111111
1XXXXXXXXXXXXXXXXX00000000000000000000000000000000X0000000000000000000000X00000000000000000000000000000000000000000000X000000XXXXXXXXXXXXXX1
1XXXXXXXXXXXXXXXXX00X000000000000000000000000000000000000000000000000000000000000000000000000000000000000000000X000000X000000XXXXXXXXXXXXXX1
1XXXXXXXXXXXXXXXXXXX00X00000000000000000000000000000000000000000000000100000000000000000000000000000000000000000000000X0000XXXXXXXXXXXXXXXX1
1XXXXXXXXXXXXXXXXXXX000000000000X0000X00000000000000000000000000000000000000000000000000000000000000X000000000000000111110011111111111111111
1XXXXXXXXXXXXXXXXX00000000000000000000000000000100000000000000000000000000000000000000000000000000000X00000000000000XXXXXXXXXXXXXXXXXXXXXXX1
1XXXXXXXXXXXXXXXXX00000000000000000000000100000000000000001000000000000000000000000000000000000000000000000000000000011111111111111111111111
1XXXXXXXXXXXXXXXXX00000000000000000001000000000000000X00000000000000000000000000000000000000000000X000000000000000000XXXXXXXXXXXXXXXXXXXXXX1
1XXXXXXXXXXXXXXXXX00000000000000000000000000000100000000000000000000000000000000000000000X00000000000000000000000000XXXXXXXXXXXXXXXXXXXXXXX1
1XXXXXXXXXXXXXXXXXXX000000000000000000000000000000000000000000000000000100001000000000000000000000000000000110000111111111111111111111111111
1XXXXXXXXXXXXXXXXXXX0000000000000000000000000000000000010000000X000000000001000000000000000000000000000X0000000000XXXXXXXXXXXXXXXXXXXXXXXXX1
1XXXXXXXXXXXXXXXXXXX0000010000000000000000000X0000000000000000000000000000000000000000000100000000000000000000000011111111111111111111111111
1XXXXXXXXXXXXXXXXXXX000000000000000000000000000000000000000000000000000000000000000000000000000000000000000000000111111111111111111111111111
1XXXXXXXXXXXXXXXXXXXXXX00000000000000000000010000000000001111000000000000001000000000000000000000000000000100000XXXXXXXXXXXXXXXXXXXXXXXXXXX1
1XXXXXXXXXXXXXXXXXXXX0000000000000000000000000000000000011111000000000000000000000000000000100100000000000000000XXXXXXXXXXXXXXXXXXXXXXXXXXX1
1XXXXXXXXXXXXXXXXXXXX00000100000000000010000000X00X00000111111111100100000000000000000000000000000010000000000001111111111111111111111111111
1XXXXXXXXXXXXXXXXXXXX00000000X0000000000000000000000000001111111110000000XX0000000100000000000000000000000000000XXXXXXXXXXXXXXXXXXXXXXXXXXX1
1XXXXXXXXXXXXXXXXXXXX00011000XX00X0000000000000000000000011111111100000XXXXXX000000000000000000010000000000000011111111111111111111111111111
1XXXXXXXXXXXXXXXXXXXXXXXXXXXXXXXXXX00XX00000000X00X0000XXXXXXXXXX00X0000XXXXX0000000000000000000000000000000000XXXXXXXXXXXXXXXXXXXXXXXXXXXX1
1XXXXXXXXXXXXXXXXXXXXXXXXXXXXXXXXXX00XXXX0001001111001111111111110000000XXXXXX000000000100000000000000000000000XXXXXXXXXXXXXXXXXXXXXXXXXXXX1
1XXXXXXXXXXXXXXXXXXXXXXXXXXXXXXXXXXXXXXXX000111111111111111111111000000111111100000000000000001000000000000000011111111111111111111111111111
1XXXXXXXXXXXXXXXXXXXXXXXXXXXXXXXXXXXXXXXXXXXXXXXXXXXXXXXXXXXXXX00000000XXXXXXXX00XXXX00000000000000000000000000XXXXXXXXXXXXXXXXXXXXXXXXXXXX1
1XXXXXXXXXXXXXXXXXXXXXXXXXXXXXXXXXXXXXXXXXXXXXXXXXXXXXXXXXXXXXX0000000111111111111111000000000000000000000000000XXXXXXXXXXXXXXXXXXXXXXXXXXX1
1XXXXXXXXXXXXXXXXXXXXXXXXXXXXXXXXXXXXXXXXXXXXXXXXXXXXXXXXXXXXXXXXX0000XXXXXXXXXXXXXXX0001001000000100001000000001111111111111111111111111111
1XXXXXXXXXXXXXXXXXXXXXXXXXXXXXXXXXXXXXXXXXXXXXXXXXXXXXXXXXXXXXXXXXXX00XXXXXXXXXXXXXXXXXXX00XX0000X0000XX000000011111111111111111111111111111
1XXXXXXXXXXXXXXXXXXXXXXXXXXXXXXXXXXXXXXXXXXXXXXXXXXXXXXXXXXXXXXXXXXXXXXXXXXXXXXXXXXXXXXXXXXXX00000000XXXXXX00XXXXXXXXXXXXXXXXXXXXXXXXXXXXXX1
1XXXXXXXXXXXXXXXXXXXXXXXXXXXXXXXXXXXXXXXXXXXXXXXXXXXXXXXXXXXXXXXXXXXXXXXXXXXXXXXXXXXXXXXXXXXXX000000XXXXXXXXXXXXXXXXXXXXXXXXXXXXXXXXXXXXXXX1
11111111111111111111111111111111111111111111111111111111111111111111111111111111111111111111111111111111111111111111111111111111111111111111
