............................................................................................................................................
............................................................................................................................................
............................................................................................................................................
............................................................................................................................................
...................................................................00...000............00000000.............................................
..................................................................00000.0000...........0000000000...........................................
...............................................................000000000.000............0000000000..........................................
...........................................00......000.........000X000000000............0000000000.........00...............................
.................................00..0000..000.....000...00.....000000000000........00000000X0000..........00...............................
................................000000000..000....0000000000000000000000X0000.00..0000000000000000........0000.00...........................
................................000000000000000.00000000000000000000000000000000000000000000000000000.....0000000...00......................
...............................0000000000000000.00XX00000000X0000000000000000000000000000000000000000.00.000000000.00000....................
...............................00000000000000000000000000000000000000000000000000011000000000000000000000000000000000000....................
...............................0000000000000000000000000000000000000000000000000100000000000000000010000000000000X0000000...................
...............................0000000000000000000000000000000000000000000000000000000000000000000000000000000000000000000000..000..........
............................00000000X000000000000000000X000000000000000000000000000000000000000000000000000001000000000000000.0000..........
............................00000000000000X000000000000000000000000000000000000000000000000000000X000000000000000000000000000.0000..........
...........................00X00000000000000000000000000000001000000000000000XX00000000000000000000000000X000000000001000000000000..........
.......................000.0000000X000000X00010000000000000000000000000000000010000000000000X0000000000000000X00000000000000000000..........
.......................000.0000000000000000000000000X00000100000000000000000000000000000000000000000000000000000010000001000000000..........
......................000...00000000000000000010000000000001001000000000000000000001000000000000000000000000000000000000000000000...........
....................00000000000000X000000000000000000000000000000000000000000000000010000000X00000000000000000000000000000000X00..00........
....................0000X0000000000000000000000000000000100000000000000000X000000000000000000000000000000000000000000000000000000.00........
.....................00000000X000000000000000000000000000001000010000000000000000000000000000000010000000000000000000000000000000.00........
.....................0000000000000000000000000000000000X00000000000000000000010000000000000000000000000X0000000000000000000000000000........
................00...000000000000000000000100000X00000000000000000000000000000000000000000000000000000000000000000000000000000000000........
..............0000000000000000000000000000000000000000X000000000000000000X0000000000000000000000000000000000000000000000000000000000........
...........0000000000000000000000000000X000000000000000000000000000000000000000000000001000000000000000000000000000000000000000X00..........
........00.00000000000000000000000000000000000000000000000000X0000000001000000000000000000000X000000000000000000000000000000000000000.......
........000.000000000000000000000000000000000X000000000100000000000000000000000000000000000000000000000000000000000000000000100000000.......
........000000000000000000000000X000000000000000000000000000000000000000000000000010000000X000000000000000000000000X00000000000000..........
........000000000000000000000000000000000000000000000000000000000000000000000000000000X00000000X000000000000000000000000000000000...........
........00000000000000000000000000000000000000000000000000000000X0000000000000000000000000000X00000000000000000000000000000000000...........
.......0000000000000000000000000000000000000000000000000000000000000000000000000000000000000000000000000000000000X0000000000000000..........
.....0000000000000000000000000000000000000000X000000X00X000000000000000000000000X0000000000000000000000000100000000000000000000000..........
.....000000000000000000000000000000000000000000000000000000000000000000000000000000000000000000000000000000000100000X00X00X000000000........
.....0000000000000000000000000000000000000000000000000000000000000000000000000000000000010000001000000000000000000000X00000000000000........
.....000000000000000000000000000000000000000000000000000000000000000000000000000000000000000000000000000000010000000000000000000000.........
.....00000000000000X00000001000000000000000000000000000X00X00000000000000000000000000000000X00X000100000000000000000000000000000000.........
....00000000000000000000000000000000000000000000000000000000000000000000000000000000000000000000000000000000000000000001000000000...........
....00000000000000000000000000000000000000000001000000000000000X0000000000000000000000X00X0000000000000000X000000000000000000000............
......00....000000000000000000000000000000000000000000000000000000000000010000000000000000000X0000X00X00X00000000000000000000000............
.....000.0000000010000100000000000000000000000000000000000000100000000000000000000000000000000000000000000000000000000000000000000..........
.....000.0000000000000000000000000000000X000000X000000000100000000000000000000000000000000100000000000000000000000000000000000000000........
.....00...0000000000X00000000000000000000000100000000000000000000000000000000000000000X000000000000000100000000000000000000000000000........
.........0000000000000000000000000000000000000000000000000000000000000000000100000000001000000000000000000001000000000000001000000000.......
.........00000000000000000000000000000000000000X0000X00000000000000000000000000000000000000000000010000000000000000000000000000000000.......
..........00X00X00X00X000000000000000100000000000000000000000000000X0000000000000000X00000000000000000000000000XX0000000000000000000........
..........00000000000000000000X000000000000000000000000X0000X000000000000000100100000000000000000000000000000000000000000000000000000.......
..........0000000000000000X0000000000000000000000000000000000000000000000000000000000000000000000000000000000000000000000000000000000.......
...........0000000000000000000000000000000000000000000000000000000000X00000000000000000000000000010000000000000000000000000000000000........
............00000000000000000000000000X0000X000000000000000000X00000000000000000000000000000001000000000000000000000000000000000............
.........000000000000X0000000000000000000000000000000000000000000000X0000000000000000000000000000000000000000000000000000000000000..........
.....00..00000000000100000000000000000000000000000000000000000000000000000000000000000000000000000000000000000000000000100000000000.........
....0000000000000000000000000000000000000000000000000000X00000001001000000000000000000000000000000000000000000100000000000000100000.........
....000000000000000000000000000000000000000000000000000000000000000000000000000000000000000000000000000000000000000000000001000000..........
.....000000000000000100000000000000000000000000000000000010000000000000000100000000000000000000000000000000000000000000100000000000.........
.....0000000000000000X0000000000000000000000000000000000X00000000000000000000000000000000000000000000000000000000000000000000000000.........
......00000000010000000000000000000000000000000X00000000000000000000000000000000000000000000000000000000000000000000000000000000000.........
.......00X0000000000000000000000000000000000000000000000000001000000000000000000000000000000000000000000000000000000000X00000000000.........
....00000000X0000000000X00000000000000000000000000000000000000010000000000000X000100000X000000000000X0000000000000000000000000000...........
....000000000000000000000000000000000000000000000000000000000000000000000000XX000000000000000000000000000000000000X0000000000000............
..000000000100000000000000000000000000000000000000000000000000000000000000000000000000000000000000000X0000000000000000000000000000..........
..000000000000000000000000000000X0000000000000000000000000000X00000000000000000001000000000000000000000000000000000000000000000000..........
..0000000000000000000000000000000000000000000000000000000000000000XX0000000000000000X00000000000000000000000000000000000000000100...........
..00000000010000000000000000000000000000000000000000000000000010011110000000000000000000000000000000000000000100000000000010000000..........
....0000..0000000000000000000000X0000000000000000000000000000XXXXXXXX0001100000000000000000000000000000010000000000000000000000000..........
....0000..000000000000000000X00000000000000000000000000X00011111111110011111000000000000000000001000000000000000000000000000010000.00.......
....00...000000000000000000X0000000000X0000000000000000010011111111111111110000000000000000000000000000000000100000000000000000000.00.......
.......000000000000000000000000000000000000000000000000000001111111111111100000000000000000000000X00000000000000000000000000000000.00.......
.....00000000000000000000000000000000000000000100001000000001111111111111100000000000000000000000000000000000000001000000000000100.0000.....
..000000000000000000000000000000000000X000000000001000000000000001111111111100000000000000000000000000000000000000000000000000000000000.....
..00000000010000000000100000000000000000X000000000000000000000000XXXXXXXXXXX0001000000000X0000000000010000000000000000000X00X00000000.......
...00000000000000000000000000000000000000000000000000000000000001111111111111111000000000000000000000000000000000000000000000000000000000...
..000000000000000100000000000000000000000000000X00X000000000000011111111111111110000000000000000001000000000000000000000000000000000000000..
..0000000000000000000000000100000000000000000000000000000000000011111111111111111000010000000000000000000000000000000000000000000000000000..
...000000000000000000000000000000000000000000000000000000X00XXXXXXXXXXXXXXXXXXXXX000000000000000000000000000000000000000000000000X0000000...
.0000X000000000001000000000000000000000000000000000000000XXXXXXX00XXXXXXX0001111000000000000000000000000000000000000000000000000000000000000
.000000000000000000000000000000000000000000000000000100001111111001111001000XXXX000100100000000000000000000000000000000000X00000000000000000
00000000000000000000000000000000000000000000000000000X0000XXX000001100001000000000000000X00000100000000000000000000000X00000000000000000100.
00000000000X0000000000000000000000000000000000000000000000X000000000000000000000000000000X0000000000000000000000000000000000000000000000000.
.000000000000000000000000000000000000000000010000000000000000000000000000001100000000000000000000000000000000000000000000000000000000000000.
0000000000000000100100000000000000000000000000000000000X000000000000000000000000X000000000000000000X00X000000000000000000010000110000000....
000000.0000.0010000000000000000000000000000000000000000000XX00000000000000000000000000000100000X0000000000000000000000000000000001000.......
.00000.00..000000000000000000000000000X000000000000000000000000000000000000000100000000000000100000000000000000000000000000000000X000.......
...........00000000X00X000000X0000000000000000000000000000000000000100000000000000000000000000000000000000000000000000000000000X000000......
............00000000000000000000000000000000000000000000000000000000000000000001000000100000X00000000000000000000000000000000000000000......
..............0000000000000000000000000000000000000000000000000000000000000000000000000000000000000000000000000000000000000000000000........
..............000000000000000000000000000000000000000000X000000000000000000000000000000000000000000000000000000000000000000000000X00........
............000000000000000000000000000000X00000001000000000000000000000000000000000X0000000000000000000100000000000000000010000100.........
...........0000000000000000000000000000010000000000000000000000000000001000000000000000X0000000000000000000000000000000000000000000.........
...........000000010010000000000000000000000000000000000000000000000000000000000000000000000000000000000000000100000000000000000000.........
...........000000000000000000000000000000000001000000000000000000000000000X000000000000000000000000000100000000000000000000000000000........
...........0000000000000000000000000100000000000000000X00X00000000000000X00000000000000000000X000000X00000000000000000000000000000000.......
.........000000000000000000000000000000000000000000000000000000000000000000000000000000000000000000X00000000X00X000000000000000000000.......
.......000000000000000000000000000000000000000000000000000000000000000000000000000000000000X0000000000000000000000000000000000000000........
.......0000000000X00X00000000000000000000000000000000000000000000000001000000001000X0000000000000000000000000000000000000000000000000.......
.......00.0000X0000X0000000000000000000000X0000X00000000000000X00000000000000000000000000000000000000X0000X00X00X000000000000000000000......
..........0000000000000000000000000000000000000000000000000100100000000000000000000000000001000000000000000000000000001000000100000000......
..........000000000000X00000000000000000000000000000000000000000000000000000000000000000000000000000000000000000000000000000000000000.......
.............0000000000000000000000000000000000000000000000000000000000000000000000000000000000X0000000000X00X00000000000000000000..........
.............0000000000000100000000000X0000000000X000000X00X000000000000000000000000000001000000000000001000000000000001000000000...........
............000000000000000000000000000000000000000000000000000000000000000000000000000000X00000000000000000000000000000000000000...........
...........00000000X0000000000000000000001000000000000000000000000000000000000000000000000000000000000000010000000000000000000000...........
...........0001000000000000000000000X00X000000000000000000000000000000000000000000X0000000000000000000100000000000000000000000000...........
............00000000X0000000100000000000000000000000000000000000000000000000000000000000000000000000000000000100000000000000100.............
............0000000000000000000000000000X000000000000000000000000000000000000000000010000100000000100001000000000000000000000000000.........
...............0000000000000000000000000000000000000000000000X000000000000000000000000000000000000000000000000000000000000000000000.........
..............0000000000X000000000000X000000000000000000010000100000X0000000000000000000000000000000000000000000000X000000000000............
..............0000000000000000000000X000000000000000100000000000000000000000000000000000000000000000X000000000000000000000000000............
..............00000000000000000000000000000000000000000000000000000000000000000000000000000000000000000000000000000000000000000.............
..............000000000001000000000000000000000X0000000000000000X00000000000000000000000100001000000000000000000000000000000000.............
..................000000000000000000X000000000000X0000000000000001000000000000000000000000000000000000000000001000X00000000000..............
..................00000000000000000000000000000000X0000000000000000000000X00000000000000000000000000000000000000000000.000000...............
..................00.000000000000000000000000000000000000000000000000000000000000000000000000000000000000000000X000000.000000...............
....................00X00000000000000000000000000000000000000000000000100000000000000000000000000000000000000000000000.0000.................
....................000000000000X0000X00000000000000000000000000000000000000000000000000000000000000X000000000000000.....00.................
..................00000000000000000000000000000100000000000000000000000000000000000000000000000000000X00000000000000........................
..................000000000000000000000001000000000000000010000000000000000000000000000000000000000000000000000000000.......................
..................00000000000000000001000000000000000X00000000000000000000000000000000000000000000X000000000000000000.......................
..................00000000000000000000000000000100000000000000000000000000000000000000000X00000000000000000000000000........................
....................000000000000000000000000000000000000000000000000000100001000000000000000000000000000000110000...........................
....................0000000000000000000000000000000000010000000X000000000001000000000000000000000000000X0000000000..........................
....................0000010000000000000000000X00000000000000000000000000000000000000000001000000000000000000000000..........................
....................000000000000000000000000000000000000000000000000000000000000000000000000000000000000000000000...........................
.......................0000000000000000000001000000000000....000000000000001000000000000000000000000000000100000............................
.....................00000000000000000000000000000000000.....000000000000000000000000000000100100000000000000000............................
.....................00000100000000000010000000X00X00000..........0010000000000000000000000000000001000000000000............................
.....................00000000.000000000000000000000000000.........0000000..0000000100000000000000000000000000000............................
.....................000..000..00.00000000000000000000000.........00000......0000000000000000000100000000000000.............................
...................................00..00000000.00.0000..........00X0000.....0000000000000000000000000000000000.............................
...................................00....000.00....00............0000000......000000000100000000000000000000000.............................
.........................................000.....................000000.......000000000000000010000000000000000.............................
...............................................................00000000........00....00000000000000000000000000.............................
...............................................................0000000...............000000000000000000000000000............................
..................................................................0000...............000.00.00000010000.00000000............................
....................................................................00...................00..0000X0000..0000000.............................
.............................................................................................00000000......00...............................
..............................................................................................000000........................................
............................................................................................................................................
