............................................................................................................................................
............................................................................................................................................
............................................................................................................................................
............................................................................................................................................
...................................................................00...000............00000000.............................................
..................................................................00000.0000...........0000000000...........................................
...............................................................000000000.000............0000000000..........................................
...........................................00......000.........0001000000000............0000000000.........00...............................
.................................00..0000..000.....000...00.....000000000000........0000000010000..........00...............................
................................000000000..000....000000000000000000000010000.00..0000000000000000........0000.00...........................
................................000000000000000.00000000000000000000000000000000000000000000000000000.....0000000...00......................
...............................0000000000000000.00110000000010000000000000000000000000000000000000000.00.000000000.00000....................
...............................00000000000000000000000000000000000000000000000000011000000000000000000000000000000000000....................
...............................000000000000000000000000000000000000000000000000010000000000000000001000000000000010000000...................
...............................0000000000000000000000000000000000000000000000000000000000000000000000000000000000000000000000..000..........
............................0000000010000000000000000001000000000000000000000000000000000000000000000000000001000000000000000.0000..........
............................0000000000000010000000000000000000000000000000000000000000000000000001000000000000000000000000000.0000..........
...........................0010000000000000000000000000000000100000000000000011000000000000000000000000001000000000001000000000000..........
.......................000.0000000100000010001000000000000000000000000000000001000000000000010000000000000000100000000000000000000..........
.......................000.0000000000000000000000000100000100000000000000000000000000000000000000000000000000000010000001000000000..........
......................000...00000000000000000010000000000001001000000000000000000001000000000000000000000000000000000000000000000...........
....................000000000000001000000000000000000000000000000000000000000000000010000000100000000000000000000000000000000100..00........
....................0000100000000000000000000000000000001000000000000000001000000000000000000000000000000000000000000000000000000.00........
.....................000000001000000000000000000000000000001000010000000000000000000000000000000010000000000000000000000000000000.00........
.....................000000000000000000000000000000000010000000000000000000001000000000000000000000000010000000000000000000000000000........
................00...000000000000000000000100000100000000000000000000000000000000000000000000000000000000000000000000000000000000000........
..............0000000000000000000000000000000000000000100000000000000000010000000000000000000000000000000000000000000000000000000000........
...........00000000000000000000000000001000000000000000000000000000000000000000000000001000000000000000000000000000000000000000100..........
........00.00000000000000000000000000000000000000000000000000100000000010000000000000000000001000000000000000000000000000000000000000.......
........000.0000000000000000000000000000000001000000000100000000000000000000000000000000000000000000000000000000000000000000100000000.......
........00000000000000000000000010000000000000000000000000000000000000000000000000100000001000000000000000000000000100000000000000..........
........0000000000000000000000000000000000000000000000000000000000000000000000000000001000000001000000000000000000000000000000000...........
........0000000000000000000000000000000000000000000000000000000010000000000000000000000000000100000000000000000000000000000000000...........
.......000000000000000000000000000000000000000000000000000000000000000000000000000000000000000000000000000000000010000000000000000..........
.....00000000000000000000000000000000000000001000000100100000000000000000000000010000000000000000000000000100000000000000000000000..........
.....0000000000000000000000000000000000000000000000000000000000000000000000000000000000000000000000000000000001000001001001000000000........
.....0000000000000000000000000000000000000000000000000000000000000000000000000000000000010000001000000000000000000000100000000000000........
.....000000000000000000000000000000000000000000000000000000000000000000000000000000000000000000000000000000010000000000000000000000.........
.....000000000000001000000010000000000000000000000000001001000000000000000000000000000000001001000100000000000000000000000000000000.........
....00000000000000000000000000000000000000000000000000000000000000000000000000000000000000000000000000000000000000000001000000000...........
....0000000000000000000000000000000000000000000100000000000000010000000000000000000000100100000000000000001000000000000000000000............
......00....00000000000000000000000000000000000000000000000000000000000001000000000000000000010000100100100000000000000000000000............
.....000.0000000010000100000000000000000000000000000000000000100000000000000000000000000000000000000000000000000000000000000000000..........
.....000.000000000000000000000000000000010000001000000000100000000000000000000000000000000100000000000000000000000000000000000000000........
.....00...00000000001000000000000000000000001000000000000000000000000000000000000000001000000000000000100000000000000000000000000000........
.........0000000000000000000000000000000000000000000000000000000000000000000100000000001000000000000000000001000000000000001000000000.......
.........0000000000000000000000000000000000000010000100000000000000000000000000000000000000000000010000000000000000000000000000000000.......
..........00100100100100000000000000010000000000000000000000000000010000000000000000100000000000000000000000000110000000000000000000........
..........000000000000000000001000000000000000000000000100001000000000000000100100000000000000000000000000000000000000000000000000000.......
..........000000000000000010000000000000000000000000000000000000000000000000000000000000000000000000000000000000000000000000000000000.......
...........0000000000000000000000000000000000000000000000000000000000100000000000000000000000000010000000000000000000000000000000000........
............00000000000000000000000000100001000000000000000000100000000000000000000000000000001000000000000000000000000000000000............
.........0000000000001000000000000000000000000000000000000000000000010000000000000000000000000000000000000000000000000000000000000..........
.....00..00000000000100000000000000000000000000000000000000000000000000000000000000000000000000000000000000000000000000100000000000.........
....0000000000000000000000000000000000000000000000000000100000001001000000000000000000000000000000000000000000100000000000000100000.........
....000000000000000000000000000000000000000000000000000000000000000000000000000000000000000000000000000000000000000000000001000000..........
.....000000000000000100000000000000000000000000000000000010000000000000000100000000000000000000000000000000000000000000100000000000.........
.....000000000000000010000000000000000000000000000000000100000000000000000000000000000000000000000000000000000000000000000000000000.........
......00000000010000000000000000000000000000000100000000000000000000000000000000000000000000000000000000000000000000000000000000000.........
.......0010000000000000000000000000000000000000000000000000001000000000000000000000000000000000000000000000000000000000100000000000.........
....00000000100000000001000000000000000000000000000000000000000100000000000001000100000100000000000010000000000000000000000000000...........
....0000000000000000000000000000000000000000000000000000000000000000000000001100000000000000000000000000000000000010000000000000............
..00000000010000000000000000000000000000000000000000000000000000000000000000000000000000000000000000010000000000000000000000000000..........
..00000000000000000000000000000010000000000000000000000000000100000000000000000001000000000000000000000000000000000000000000000000..........
..0000000000000000000000000000000000000000000000000000000000000000110000000000000000100000000000000000000000000000000000000000100...........
..00000000010000000000000000000000000000000000000000000000000010011110000000000000000000000000000000000000000100000000000010000000..........
....0000..000000000000000000000010000000000000000000000000000111111110001100000000000000000000000000000010000000000000000000000000..........
....0000..000000000000000000100000000000000000000000000100011111111110011111000000000000000000001000000000000000000000000000010000.00.......
....00...0000000000000000001000000000010000000000000000010011111111111111110000000000000000000000000000000000100000000000000000000.00.......
.......000000000000000000000000000000000000000000000000000001111111111111100000000000000000000000100000000000000000000000000000000.00.......
.....00000000000000000000000000000000000000000100001000000001111111111111100000000000000000000000000000000000000001000000000000100.0000.....
..0000000000000000000000000000000000001000000000001000000000000001111111111100000000000000000000000000000000000000000000000000000000000.....
..00000000010000000000100000000000000000100000000000000000000000011111111111000100000000010000000000010000000000000000000100100000000.......
...00000000000000000000000000000000000000000000000000000000000001111111111111111000000000000000000000000000000000000000000000000000000000...
..0000000000000001000000000000000000000000000001001000000000000011111111111111110000000000000000001000000000000000000000000000000000000000..
..0000000000000000000000000100000000000000000000000000000000000011111111111111111000010000000000000000000000000000000000000000000000000000..
...00000000000000000000000000000000000000000000000000000010011111111111111111111100000000000000000000000000000000000000000000000010000000...
.0000100000000000100000000000000000000000000000000000000011111110011111110001111000000000000000000000000000000000000000000000000000000000000
.0000000000000000000000000000000000000000000000000001000011111110011110010001111000100100000000000000000000000000000000000100000000000000000
0000000000000000000000000000000000000000000000000000010000111000001100001000000000000000100000100000000000000000000000100000000000000000100.
0000000000010000000000000000000000000000000000000000000000100000000000000000000000000000010000000000000000000000000000000000000000000000000.
.000000000000000000000000000000000000000000010000000000000000000000000000001100000000000000000000000000000000000000000000000000000000000000.
0000000000000000100100000000000000000000000000000000000100000000000000000000000010000000000000000001001000000000000000000010000110000000....
000000.0000.0010000000000000000000000000000000000000000000110000000000000000000000000000010000010000000000000000000000000000000001000.......
.00000.00..00000000000000000000000000010000000000000000000000000000000000000001000000000000001000000000000000000000000000000000001000.......
...........000000001001000000100000000000000000000000000000000000001000000000000000000000000000000000000000000000000000000000001000000......
............00000000000000000000000000000000000000000000000000000000000000000001000000100000100000000000000000000000000000000000000000......
..............0000000000000000000000000000000000000000000000000000000000000000000000000000000000000000000000000000000000000000000000........
..............0000000000000000000000000000000000000000001000000000000000000000000000000000000000000000000000000000000000000000000100........
............00000000000000000000000000000010000000100000000000000000000000000000000010000000000000000000100000000000000000010000100.........
...........000000000000000000000000000001000000000000000000000000000000100000000000000010000000000000000000000000000000000000000000.........
...........000000010010000000000000000000000000000000000000000000000000000000000000000000000000000000000000000100000000000000000000.........
...........0000000000000000000000000000000000010000000000000000000000000001000000000000000000000000000100000000000000000000000000000........
...........00000000000000000000000001000000000000000001001000000000000001000000000000000000001000000100000000000000000000000000000000.......
.........0000000000000000000000000000000000000000000000000000000000000000000000000000000000000000001000000001001000000000000000000000.......
.......00000000000000000000000000000000000000000000000000000000000000000000000000000000000010000000000000000000000000000000000000000........
.......000000000010010000000000000000000000000000000000000000000000000100000000100010000000000000000000000000000000000000000000000000.......
.......00.0000100001000000000000000000000010000100000000000000100000000000000000000000000000000000000100001001001000000000000000000000......
..........0000000000000000000000000000000000000000000000000100100000000000000000000000000001000000000000000000000000001000000100000000......
..........000000000000100000000000000000000000000000000000000000000000000000000000000000000000000000000000000000000000000000000000000.......
.............000000000000000000000000000000000000000000000000000000000000000000000000000000000010000000000100100000000000000000000..........
.............00000000000001000000000001000000000010000001001000000000000000000000000000001000000000000001000000000000001000000000...........
............000000000000000000000000000000000000000000000000000000000000000000000000000000100000000000000000000000000000000000000...........
...........0000000010000000000000000000001000000000000000000000000000000000000000000000000000000000000000010000000000000000000000...........
...........0001000000000000000000000100100000000000000000000000000000000000000000010000000000000000000100000000000000000000000000...........
............0000000010000000100000000000000000000000000000000000000000000000000000000000000000000000000000000100000000000000100.............
............00000000000000000000000000001000000000000000000000000000000000000000000010000100000000100001000000000000000000000000000.........
...............00000000000000000000000000000000000000000000001000000000000000000000000000000000000000000000000000000000000000000000.........
..............000000000010000000000001000000000000000000010000100000100000000000000000000000000000000000000000000001000000000000............
..............000000000000000000000010000000000000001000000000000000000000000000000000000000000000001000000000000000000000000000............
..............00000000000000000000000000000000000000000000000000000000000000000000000000000000000000000000000000000000000000000.............
..............00000000000100000000000000000000010000000000000000100000000000000000000000100001000000000000000000000000000000000.............
..................000000000000000000100000000000010000000000000001000000000000000000000000000000000000000000001000100000000000..............
..................0000000000000000000000000000000010000000000000000000000100000000000000000000000000000000000000000000.000000...............
..................00.0000000000000000000000000000000000000000000000000000000000000000000000000000000000000000001000000.000000...............
....................00100000000000000000000000000000000000000000000000100000000000000000000000000000000000000000000000.0000.................
....................000000000000100001000000000000000000000000000000000000000000000000000000000000001000000000000000.....00.................
..................00000000000000000000000000000100000000000000000000000000000000000000000000000000000100000000000000........................
..................000000000000000000000001000000000000000010000000000000000000000000000000000000000000000000000000000.......................
..................000000000000000000010000000000000001000000000000000000000000000000000000000000001000000000000000000.......................
..................00000000000000000000000000000100000000000000000000000000000000000000000100000000000000000000000000........................
....................000000000000000000000000000000000000000000000000000100001000000000000000000000000000000110000...........................
....................0000000000000000000000000000000000010000000100000000000100000000000000000000000000010000000000..........................
....................0000010000000000000000000100000000000000000000000000000000000000000001000000000000000000000000..........................
....................000000000000000000000000000000000000000000000000000000000000000000000000000000000000000000000...........................
.......................0000000000000000000001000000000000....000000000000001000000000000000000000000000000100000............................
.....................00000000000000000000000000000000000.....000000000000000000000000000000100100000000000000000............................
.....................00000100000000000010000000100100000..........0010000000000000000000000000000001000000000000............................
.....................00000000.000000000000000000000000000.........0000000..0000000100000000000000000000000000000............................
.....................000..000..00.00000000000000000000000.........00000......0000000000000000000100000000000000.............................
...................................00..00000000.00.0000..........0010000.....0000000000000000000000000000000000.............................
...................................00....000.00....00............0000000......000000000100000000000000000000000.............................
.........................................000.....................000000.......000000000000000010000000000000000.............................
...............................................................00000000........00....00000000000000000000000000.............................
...............................................................0000000...............000000000000000000000000000............................
..................................................................0000...............000.00.00000010000.00000000............................
....................................................................00...................00..000010000..0000000.............................
.............................................................................................00000000......00...............................
..............................................................................................000000........................................
............................................................................................................................................
