
0001 0002 0003 0004 0005 0006 0007 0038 -0001 0072 0057 0058 0059 0124 0123 0122 0121 0120 0119 0118 


0117 0112 0013 0012 0011 0008 0010 0037 0039 0073 0056 0060 0069 0070 0125 0127 0128 0149 0148 0147 


0115 0113 0111 0014 0109 0009 0041 0036 0040 0074 0055 0061 0068 0071 0126 0150 0129 0131 0132 0133 


0116 0114 0110 0015 0017 0018 0075 0035 0042 0043 0054 0062 0063 0064 -0001 0151 0130 0146 0145 0134 


0100 0108 0107 0016 0019 0077 0076 0034 0044 0051 0052 0053 0065 0067 -0001 -0001 -0001 0144 0143 0135 


0099 0101 0102 0103 0020 0022 0023 0033 0045 0046 0047 -0001 0066 -0001 -0001 -0001 -0001 -0001 0142 0136 


0098 0106 0105 0104 0021 0024 0030 0031 0032 0048 0050 0175 0173 0174 -0001 -0001 -0001 0140 0139 0137 


0082 0081 0080 0079 0078 0025 0027 0028 0167 0049 -0001 0177 0172 0176 -0001 -0001 0162 0161 0141 0138 


0083 0097 0096 0095 0094 0026 0029 0093 0166 0164 0165 0179 0171 0178 -0001 -0001 0155 0154 0153 0152 


0084 0085 0086 0087 0088 0089 0090 0091 0092 0163 0168 0169 0170 0180 0181 0160 0159 0156 0157 0158 

