1F----7F7F7F7F-71111
1|F--7||||||||FJ1111
1||1FJ||||||||L71111
FJL7L7LJLJ||LJ1L-711
L--J1L7111LJF7F-7L71
1111F-J11F7FJ|L7L7L7
1111L71F7||L7|1L7L7|
11111|FJLJ|FJ|F7|1LJ
1111FJL-71||1||||111
1111L---J1LJ1LJLJ111
