#............#....##..#...#.#.#.#.#....#..#..#...#...#.#.#...#..##.....#....#...###.............#..##.###..#..
#............#....##..#...#.#.#.#.#....#..#..########################################...........#..##.###..#..
#............#....##..#...#.#.#.#.#....#..#......#...#.#######..##.....#...##...###.#...........#..##.###..#..
#............#....#####...#.#.#.#.#....##################################################################..#..
#............#.########...#.#.#.#.#.......#.#....####################################...........#..##.##...#..
#............#.#..#############################...#..#.########################################.#..##.##...#..
#.........#####################.#.#.......#.#.#...#..#.###.###..#......#...###..###.#.........#.#..##.##...#..
#.........#..#.#...#.##...#.#######################..#.#################################################...#..
#######################.#####################.#......#.###.###..#......#...#############################...#..
..........#..#.#...#.#..#########.#.......###.#......#.###.###..#...#####..#.#..###.#...........#.############
....###############################.......###.#.....###################################################....##.
....#....##..#.#...#.#########################################################################################
....#....##..#.#...#.#..###########.......###.#.#...##.#.#.#.#..#...#..##..#.#..###.#...........#..##.#....##.
....#....##..#.#...#.#..#############################################################...........#..##.#....##.
....#....##..#.#...#.#..#####.#####.......##################################.#..#####...........#..##.#....##.
....#....####################.##############################.#..#...#..##....#..#####.#######################.
....#....##..#.#...#.#.######.#####.....#######.##.#.#.#.#...#..#...#..##....#..#####.########################
....#....##..#.##############.#####.....#.#####.##.#.#.##########################################..###########
....#....##..#.##..#.#.######.################################################..#####.#............###......##
####################.#..##.##.#.###.....#.#####.##.#.#.#.#...#..#...#..##...##..#####.#............###......##
....#....################################.#####.##.#.#.########.#...#..##...##..#####.#............#######..##
##################################.....##.#####.##############################################################
##################...#..##.##.#.##.....##.#####.##########..###.#...#..##...##..#####.#.............##...#..#.
....#.....#..#.###...#..##.##.#.##.....##.#########################################################.##...#..#.
....#.....#..#.###...#..##.#######################.#.#......###.#...#..##############.#...........#.##...#..#.
....###########################################################.#...#..###...#...####.#...........#.##...#..#.
....#.....#..#.###...#..##..#.#.##.#################.#......##..#...#..###...#################################
###.#....#########################################...#......##..#...#..###...##..####.#...........#.##...#..#.
..#.#....##..#.####..#..##..#.#.##.##..##..#####.#...#......##..#...#..###...##############.......#.##...#..#.
..#.#######..#.####..#..##..#.#.##.##..##..#####.#...#......##..#...#..###...#...####.#...#.......#.##...#..#.
..#......#...#.#################################.#...#......#########################.#...#.......#.##...#..#.
..#......#...#.##############.#.##.##..###.##.########################.###...#...#.##.#...#.......#.##...#..#.
###################..#..##.##.#.##.##..#######################################################################
##############################################################################################################
..#.....##...#..###..#..##.##.#.##.##..#######################################################################
..#.....##...#..###..#..##.##.#.##.##..###.###########...#############################################.######.
..#.....##############################################...#.###..##################.##.##..##....#.#..#.#.#..#.
..##########.#..##########################################################.........##############.#..#.#.#..#.
........##.###############.##.#.##.##..###.#..#######################..##..........#.###..##...##.#..#.#.#..#.
........##...#...##..#..##.##.#.##.##..###.#..##.#####...#####..#.##...##..........#.###..##############.#..#.
##########################.##.#.#####..###.#.#######################################.###...##..##.#..#...#..#.
........##...#...##..#..#..##.#.#####..###.#.#################..#.##...##.........##.###...##..##.#..#...#..#.
........##...#...##..#..#..##.#.#####..##################################.........##.###...##..##.#..#...#..#.
........##...#...##..#..#..##.#.#####..###.#.######################################################..#...#..#.
........##...#...##..#..#..###########################################..#.........##.####..##..##....#########
........##...#...##..#..#...#.#..####..#######################..#.##.#..#.........##.####..##..##....##..#..#.
........##...#...#..####################################.#.###..#.##.#..##........##.####..##..##....##..#..#.
##############################################################..#.##########.....#########.##..##....##..#..#.
........##...#########################..##.#.##########..#.#.#..#.####..##.#....##########.##..###############
........##...#...#..##..#.....#..#####..##.#.#######################################.#.###.##..###...##..#..#.
........##...#...#####################################################..######################################
###########..#...##.##..##....#..#####..##.#.##########..#.#.##.#.####..######################################
......################..##....#..#####################################...###########################.##..#..#.
......#.###..#...##.##..##....#..######.##.#.##########..#.#.##.#.##########....####.#.#############.##..#..#.
......#.##########################################################################################.#.##..#..#.
###########..#############################.#.##########..#.#.##.#.####....##....####.#.###.##...##.#.##..#..#.
......#...#..#...#####################################################....##########################.##..#..#.
......#...#..#...##.##..###..##..############################################...####.#.###.##...##.#.##..#..#.
......#..########################################################.##....#.###...##############################
#################################################################.##....#.###...#############################.
......#..##..#...##.....###..##...########.#######################################################.#.##..#....
......#..##..#...#########################################.#.#.##.###########...####.#.######...##.#.##..#....
......#..##..#...##......##..##...#####.##...#############.#.#.##.###...#.###...####.#.######...##############
......####################################...#############.#.#.##.###...######################################
.........##..#...##......#################...#############.#.#.##.###.....###.#.####.#.######...##.#.##..#....
.....#######################################################.################################...##.#.##..#....
.....#...##..#...######..###.##...###########################################################...##.#.##..#....
.....#...##..#...#....#..###.#############..##################.##.###.....#####.####.#.################..#....
.....#...##..#...#....########################################.##.#############.####.#.####.#....#.####..#....
.....#...##..#...#....##.###..############..##################.##.####....####################################
.....#...##..#...#....##.###.....#####################################.....##.#.####.#.####.#....#.####..#..#.
.....#################################################################.....############################..#..#.
###########.####.#....##.###...#########################.#####.##..##.......#.#.####.#..###.#....#.###...#..#.
.....##.#.#.##.#.#....########################################################################################
.....##.#.#.##.#.#.#########...#...####.#####################..##..##.......#.################################
.....##.#.#.##.#.#.#..#.####...#...####.####.##.#####....###...##..#####....#.#.####.##.###.#....#.###...#..#.
.....##.######.#.#.#..#.####...#...####.####.##.#####....###...##..#...#....#.#.##################.###########
###########.#..#.#.#..######...#...####.####.###########.###...##..#...#....#.#.####.##.###.#...#...##...#..#.
.....##.###.#..#.#.#..######...#...####.####.########..#.###...##..#...#....#.#.##############################
..##################################################################...#....#.#.####.##.###.#...#...##......#.
..################################.##################..#.##....##..#...#....#.#.####.##.###.#...#...##......#.
################.#.#..###############################..#.##....##..#...#....#.#.####.##.###.#...#.############
####################################################################...#....#.#.####.##########.#.#.##......#.
###########..###.#.#..######...#.#.##################..#.##....##.##...#....#.#.####.##.###.#.#.#############.
..##.######..###.#.#.###################################.##....##.##...#....#.#.####.##.#...#.#.###.##........
..##########################...#...####################################################.#...##########........
..##..#..#...###.#.#.################################..#.##....##.#....#....#.#.####.####.......###.##........
..######################################.############..#.#####.##.#....#....#.#.###################.##........
..#...#..#...###.#.##################################..#.###.#.##########################.......#.####........
..#...#..#...###.#...##..#.#...#...####..########..##############################################.#..#........
######################################################################.#....#.#..###.####.........#..#........
############################################################.#.#..##.#.#...##############.........#..#........
..#...#.##...#################################################.#..##.#.#...##.#..########.........#..#........
..#...#.##############################################################################################........
..#...#.##....####...##..#.#.#.#...####.####.####..#####.###...#..##.#.###############################........
..#...#.##....####...##..#.#.#.#...####.####################...##########################.........#.#.........
..#...#.##....####...##..#.#.#.#...####.#########...##.....#...#..##.#.##..##.#..####.###.........#.#.........
..#...#############..##..#.#.#.#...##############...##.....##############..##.#..####.###.........#.#.........
##########....#####..##..#######...#.##..###.#..#...##.........#..##.#.##..##.#..####..##.........#.#.........
..#......#....#####..##...##.#.....#.##..#####################################################################
#######################...####.....#.##..##..####...##.......########################..##.........#.#.........
.........#....#########....#########.##..##....##...##.......#.#..##.#.##############..##.........###.........
.........#....##.##..##.....##....##.##..##....##...#####################################...........#.........
.........#....#############.##....##.####################....#.#..##.#..#..##.#..####.###...........#.........
.........#.....#.##..##...#.##....##..#...#....##...#.#.#....#.#..###################.###...........#.........
###################..###############..#...#....##...#.#.#....#.#..###########.#..#.######...........#.........
.........#.....#.##########..#.....#..#...#....##...#.#.#....#.##############.#######################.........
.........#.....#.....#....#..#.....#..#...#....##...#.#.#....#....##########################..................
.........#.....#.....#....#..#.....#..#...#....##########################################..#..................
.........#.....#.....#....#..#.....#..#...#....###..#...#....#....#######...#.......#..#...#..................
